AAAAAAAAAAAAAAAAAAA
ADDDDDDDDADDDDDDDDA
ACAADAAADADAAADAACA
ADDDDDDDDDDDDDDDDDA
ADAADADAAAAADADAADA
ADADDADDDDDDDADDADA
BDDDAADEFFFHDAADDDB
ADAAADDDDBDDDDAAADA
ADDDDDAAAAAAADDDDDA
ADAAADAADDDAADAAADA
ACAAADAADADAADAAACA
ADDDDDDDDADDDDDDDDA
AAAAAAAAAAAAAAAAAAA

