AAAAAAAAAAAAAAAAAAA
ADDDDDDDDADDDDDDDDA
ACAAAAAADADAAAAAACA
ADDDDDDDDDDDDDDDDDA
ADAAAAAAAAAAAAAAADA
ADDDDDDDDDDDDDDDDDA
BDAAAADEFFFHDAAAADB
ADDDDDDDDBDDDDDDDDA
ADAAAAAAAAAAAAAAADA
ADDDDDDDDDDDDDDDDDA
ACAAAAAADADAAAAAACA
ADDDDDDDDADDDDDDDDA
AAAAAAAAAAAAAAAAAAA

